████████████████████████████████████
█       █       █       █       █  █
█   H   █   ♨   █   ♨   █   ♨   █  █
█       █       █       █       █  █
█ █████████████████████████████ █  █
█ █       █       █       █   █ █  █
█ █   ♨   █   ♨   █   ♨   █   █ █  █
█ █       █       █       █   █ █  █
█ ██████████████████████████ █ █ █  █
█         █       █       █ █ █ █  █
█     D   █   ♨   █   ♨   █ █ █ █  █
█         █       █       █ █ █ █  █
████████████████████████████████████
